10
1  1  1  0  0  0  0  0  1  0
0  0  0  0  1  1  1  0  0  1
0  1  0  0  0  0  0  0  0  1
0  1  0  1  1  0  0  1  X  1
0  1  1  0  0  0  1  1  0  0
0  0  0  0  1  0  1  1  0  1
0  0  0  0  1  0  0  0  0  0
0  1  0  1  0  0  0  1  0  1
0  F  1  0  0  0  1  0  0  1
1  1  0  1  1  0  1  0  0  0
20
1  0  0  0  0  0  0  1  0  1
1  1  1  1  0  0  0  0  1  1
1  1  1  0  1  0  1  0  0  1
0  0  0  1  1  0  0  1  0  F
0  1  0  1  0  1  0  1  1  0
0  0  0  1  0  0  0  1  1  0
0  1  1  0  0  1  1  1  0  0
X  0  0  0  1  0  0  0  0  1
1  0  1  0  0  0  1  0  1  0
0  0  0  0  0  0  0  0  0  0
30
0  0  0  0  0  0  0  0  0  1
0  0  1  0  1  0  1  1  0  1
0  1  1  0  1  0  0  1  1  0
0  1  0  X  0  0  0  1  0  0
0  0  0  0  0  1  0  1  0  0
1  1  0  1  0  0  0  0  1  0
0  0  0  0  1  0  0  0  0  F
1  1  0  0  1  0  0  0  1  0
1  0  1  0  0  0  1  0  1  0
1  0  0  1  0  0  0  0  0  0
40
1  0  1  0  1  0  1  0  1  0
0  0  0  0  0  0  0  0  0  1
1  0  1  0  1  0  1  0  1  1
1  0  1  0  0  1  0  0  0  0
0  0  0  0  0  0  0  1  1  0
1  0  0  1  0  0  0  1  1  0
0  X  1  0  0  0  0  1  0  0
1  0  0  0  1  1  0  1  1  0
0  0  1  1  1  0  0  0  1  0
1  0  0  0  0  0  1  0  0  F
50
1  0  0  1  1  0  0  1  1  0
0  1  1  0  0  0  1  0  0  1
1  0  0  0  1  0  0  0  1  0
0  0  0  1  1  1  1  1  0  0
1  1  0  0  0  1  1  1  0  F
0  1  0  1  0  0  0  1  0  0
1  0  0  1  0  1  0  1  0  0
0  0  0  0  0  0  0  1  1  0
1  0  0  1  1  1  0  1  0  0
0  X  1  1  0  1  0  0  0  0